T: The The The The The T 
d: does disciplined decertified duties, did 
": "blue 
L: Louisiana. 
p: period, protected precautions procedures personnel personnel perform procedures. panel procedures processes personnel. 
B: B-52H Base Barksdale Base Barksdale Bent Base Board Based 
t: transported to the to the taken their the to the this the the to the top the to that the threat to the the the that the their to types transport the the that the the the this the the their to the the to 
b: bomber been before bunker. both by by but been by by but by bombers, 
h: heavy have hours. handling had handling handling 
2: 2007 29–30 2007. 2007. 2008, 2008, 
n: nuclear nuclear nuclear nuclear not not nuclear nuclear not nuclear nuclear not numerous numerous nuclear new nuclear nuclear not nuclear nuclear 
f: from for for followed four further from for find failures for 
v: variable various 
(: (USAF) (DoD) 
J: June 
F: Force Force Force Force Force Force Force Force 
r: removed reported remained reported referred response results released result, relieved ribbon" reported resignations, response recommendations review 
l: loaded loaded levels 
N: North 
D: Dakota During Department Defense Defense Department Defense 
w: weapons with warhead, were warheads were were with warheads were warheads were weapons. was which weapon war. which were weapons were were weapons were weapons weapons within with weapons. were which were 
s: supposed storage security significant standards sensitive suspended. security 
e: each existed 
G: General Global 
M: Minot Minot Minot Michael Michael Moseley 
5: 5 
a: a a at and and aircraft at and and as a a and an and a and/or and and at addition, and and a and any and and asked a announced all and 
i: incident in in in incident incident, indicates incident is involve immediate incident, investigation, investigation involved in incident. issued instructions investigations incidents, in 
y: yield 
A: Air August AGM-129 ACM Air Air Air As Air Air Air Air 
I: In In In 
o: occurred on onto of observers of of of of on of other of operations on of of on other on of of of of 
O: October October 
3: 36 
S: States Six States States Spear States Separate Science States Secretary Staff Strike 
C: Chief Command 
U: United United United United USAF USAF USAF USAF USAF USAF United USAF USAF 
1: 19 
g: given. 
–: – – 
m: missiles, mistakenly missiles missiles missiles missing, mounted mandatory military missile missions missiles, 
W: W80-1 Wynne 
c: cruise concern conducted concluded commanders commands, certain cruise concerns committee, creation control 
